Gwen Stefani - Hollaback Girl 
The Game Featuring 50 Cent - Hate It Or Love It 
50 Cent Featuring Olivia - Candy Shop 
Akon - Lonely 
Ciara Featuring Ludacris - Oh 
Kelly Clarkson - Since U Been Gone 
Rob Thomas - Lonely No More 
Coldplay - Speed Of Sound 
Frankie J Featuring Baby Bash - Obsession (No Es Amor) 
Amerie - 1 Thing 
Green Day - Boulevard Of Broken Dreams 
Mariah Carey - We Belong Together 
The Killers - Mr. Brightside 
50 Cent - Just A Lil Bit 
50 Cent - Disco Inferno 
Bobby Valentino - Slow Down 
Will Smith - Switch 
Trillville Featuring Cutty - Some Cut 
Green Day - Holiday 
Natalie - Goin' Crazy 
The Black Eyed Peas - Don't Phunk With My Heart 
Alicia Keys - Karma 
Gwen Stefani Featuring Eve - Rich Girl 
Mario - Let Me Love You 
Ciara Featuring Missy Elliott - 1, 2 Step 
Trick Daddy Featuring Ludacris, Lil' Kim & Cee-Lo - Sugar (Gimme Some) 
Usher - Caught Up 
T.I. - U Don't Know Me 
3 Doors Down - Let Me Go 
Brooke Valentine Featuring Lil Jon & Big Boi - Girlfight 
Ludacris - Number One Spot 
Ying Yang Twins - Wait (The Whisper Song) 
Mariah Carey - It's Like That 
The Game Featuring 50 Cent - How We Do 
Backstreet Boys - Incomplete 
Fantasia - Truth Is 
Destiny's Child - Girl 
Kelly Clarkson - Breakaway 
American Idol Finalists Season 4 - When You Tell Me That You Love Me 
Howie Day - Collide 
The Used And My Chemical Romance - Under Pressure 
112 Featuring Foxy Brown - U Already Know 
The White Stripes - Blue Orchid 
Baby Bash Featuring Akon - Baby I'm Back 
Weezer - Beverly Hills 
Kelly Clarkson - Behind These Hazel Eyes 
Cassidy - I'm A Hustla 
John Legend - Ordinary People 
Nivea Featuring Lil Jon & YoungBloodZ - Okay 
Omarion - O 
Bowling For Soup - Almost 
Pretty Ricky - Grind With Me 
Faith Evans - Again 
Mario - How Could You 
Lifehouse - You And Me 
Eminem - Mockingbird 
Papa Roach - Scars 
Montgomery Gentry - Gone 
Jet - Look What You've Done 
Audioslave - Be Yourself 
Kenny Chesney - Anything But Mine 
Brooks & Dunn - It's Getting Better All The Time 
Gretchen Wilson - Homewrecker 
Mike Jones Featuring Slim Thug & Paul Wall - Still Tippin' 
Keith Urban - Making Memories Of Us 
Maroon 5 - Sunday Morning 
Andy Griggs - If Heaven 
Jo Dee Messina - My Give A Damn's Busted 
Anna Nalick - Breathe (2 AM) 
Trace Adkins - Songs About Me 
Craig Morgan - That's What I Love About Sunday 
Snoop Dogg Featuring Charlie Wilson & Justin Timberlake - Signs 
Gavin DeGraw - Chariot 
Dierks Bentley - Lot Of Leavin' Left To Do 
Nine Inch Nails - The Hand That Feeds 
Josh Gracin - Nothin' To Lose 
Joe Nichols - What's A Guy Gotta Do 
Toby Keith - Honkytonk U 
Jennifer Lopez - Get Right 
Beck - E-Pro 
Jack Johnson - Sitting, Waiting, Wishing 
System Of A Down - B.Y.O.B. 
George Strait - You'll Be There 
Mary J. Blige Featuring The Game & 50 Cent - MJB Da MVP 
Fat Joe - So Much More 
Rascal Flatts - Fast Cars And Freedom 
Tim McGraw - Drugs Or Jesus 
Jennifer Lopez Featuring Fat Joe - Hold You Down 
Fantasia - Free Yourself 
Destiny's Child - Cater 2 U 
Marques Houston Featuring Young Rome - All Because Of You 
Mudvayne - Happy? 
Juanes - La Camisa Negra 
Phil Vassar - I'll Take That As A Yes (The Hot Tub Song) 
The Pussycat Dolls Featuring Busta Rhymes - Don't Cha 
Caesars - Jerk It Out 
Lonestar - Class Reunion (That Used To Be Us) 
Shakira Feat. Alejandro Sanz - La Tortura 
Webbie Featuring Bun B - Give Me That 
R. Kelly - Trapped In The Closet 
